11111111
10000001
10000001
1000x001
10000001
10000001
10000001
11111111