11111111111111
10000000010001
10000101000101
100x0111110101
10000100010101
10000101000101
10000001010001
11111111111111