11111111111111111111
10000000000000000001
10000011111110000001
10000010000001000001
10000010000000100001
10000010000000010001
1000000000x000001001
10000000000000000101
10000000000000000001
10111111110000000001
10000000000000000001
10000000000001111001
10000000000001001001
10000000000001001001
10001100000001001001
10001100000001001001
10000000000001111001
10000000000000000001
10000000000000000001
11111111111111111111
