11111
10001
10x01
10001
11111
