1111111111111111111111111111111111111111111111111
1000000000001000000000100000000000000000000000001
100x001111111000000000010000000000000000000000001
1000001000000100001100001000000000000000000000001
1000001001100010000010001000000000000000000000001
1000001011100001000001001000000000000000000000001
1011001011100000100000101000000000000000000000001
1001010011100000010000101000000000000000000000001
1101000011100000000000101000000000000000000000001
1011111111100111111100101000000000000000000000001
1000000000000100000000101000000000000000000000001
1010101010101101100000101000000000000000000000001
1000000000000100100111101000000000000000000000001
1010101010101110100000101000000000000000000000001
1000000000000100111110101000000000000000000000001
1010101010101100100000100000000000000000000000001
1000000000000111111111111111111111111111111110101
1010101010101000000000000000000000000000000000001
1000000000000000000000000000000000000000000000001
1010101010101010101010101010101010101010101010101
1000000000000000000000000000000000000000000000001
1101010101010101010101010101010101010101010101011
1000000000000000000000000000000000000000000000001
1010101010101010101010101010101010101010101010101
1111111111111111111111111111111111111111111111111
