000000000000000000000000000011111111111110000
000001111111000000000000000010000000000010000
000001000001000000111111111110000000000011111
000001000001000000100000000010000000000010001
000001000000100000100000000000000000000000001
000001000000100000100000000010000000000010001
000001111110111110100011111110000000000011111
000001000000000010100010000010000000000010000
000001000000000011100011100011111101111110000
000001000000000010000000100000001000100000000
000001000000000000000000100000001000100000000
000001000000000010000000100000001000100000000
111111000000000011111111100000001000100000000
100011000000000010000000000000001000100000000
100011111101111110000000000111111000111000000
100010001000100000000000000100000000001000000
110110001000100000000000000100111000111000000
100011111000100000000000000100111000100000000
100010001000100000000000000100111000100000000
100000001000100000000000000111111000100000000
100010001000100000000000000000001000100000000
100011111101111100000000000000011101110000000
100011000000000100000000001111110000011111111
100011000000000100000000001000000000000000011
100011000000000100000000001000000000000000011
100001000000000100000000001000000000000000001
100000000000000100000000001000000000000000001
100001000000000100000000001000000000000000001
100011000000000100000000001000000000000000011
100011000000000100000000001000000000000000011
100011000000000100000000001111111000001111111
100011111101111100000000000000001110111000000
100011111000100000000000000000000100010000000
100011111000100000000000000000000100010000000
100010001000100000000000000000000100010000000
100000001000100000000000000000000100010000000
100010001000100000000000000000000100010000000
100011111000100000000000000001111111011111110
100011111000111111111111110001000010001000010
100000000000000000100000011101000000000000010
100000000000000000000000000101000010001000010
100000000000000000100000011101111110001111110
111111111111111111111111110001000010001000010
0000000000000000000000000000010x0000000000010
000000000000000000000000000001000010001000010
000000000000000000000000000001111111111111110