111111111111111111111111111111111111111111111111
100000000000000000000000000001111111111111000011
100000111111100000000000000001000000000001000011
100000100000100000011111111111000000000001111111
100000100000100000010000000001000000000001000111
100000100000010000010000000000000000000000000111
100000100000010000010000000001000000000001000111
100000111111011111010001111111000000000001111111
100000100000000001010001000001000000000001000011
100000100000000001110001110001111110111111000011
100000100000000001000000010000000100010000000011
100000100000000000000000010000000100010000000011
100000100000000001000000010000000100010000000011
111111100000000001111111110000000100010000000011
110001100000000001000000000000000100010000000011
110001111110111111000000000011111100011100000011
110001000100010000000000000010000000000100000011
111011000100010000000000000010011100011100000011
110001111100010000000000000010011100010000000011
110001000100010000000000000010011100010000000011
110000000100010000000000000011111100010000000011
110001000100010000000000000000000100010000000011
110001111110111110000000000000001110111000000011
110001100000000010000000000111111000001111111111
110001100000000010000000000100000000000000001111
110001100000000010000000000100000000000000001111
110000100000000010000000000100000000000000000111
110000000000000010000000000100000000000000000111
110000100000000010000000000100000000000000000111
110001100000000010000000000100000000000000001111
110001100000000010000000000100000000000000001111
110001100000000010000000000111111100000111111111
110001111110111110000000000000000111011100000011
110001111100010000000000000000000010001000000011
110001111100010000000000000000000010001000000011
110001000100010000000000000000000010001000000011
110000000100010000000000000000000010001000000011
110001000100010000000000000000000010001000000011
110001111100010000000000000000111111101111111011
110001111100011111111111111000100001000100001011
110000000000000000010000001110100000000000001011
110000000000000000000000000010100001000100001011
110000000000000000010000001110111111000111111011
111111111111111111111111111000100001000100001011
10000000000000000000000000000010x000000000001011
100000000000000000000000000000100001000100001011
100000000000000000000000000000111111111111111011
111111111111111111111111111111111111111111111111